1 1 1 0 1 1 1 1
1 v 0 0 0 0 v 1
1 1 1 p 0 1 1 1
1 0 0 0 0 0 0 1
1 1 1 0 1 1 1 1